000000000000011111111111111111111111111111110000000000000
000000000000010000000000000000000000000100010000000000000
000000000000010000000000000000000000000500010000000000000
000000000000010000000000000000000000000100010000000000000
000000000000010001110111111100011111511111111111111111100
000000000000010001100010111115111110001001000000010000100
000000000000010001100010100000000010001001000000010000100
000000000000010001100010100000000010001001000000010000100
000000000000010001111111100000000011111111000000010000100
000000000000010000000000100000000010000001000000010011100
000000000000010000000000500000000050000005000000050010000
000000000000010000000000100000000010000001000000011110000
000000000000010001111111100000000011111111000000010000000
000000000000010001000000100000000010000001000000010000000
000000000000010001000000100000000010000001000000010000000
000000000000010001000000111111111110000001111511110000000
000000000000010001000000000000000000000000010001000000000
000000000000011B11000000000000000000000000010001111111100
000000000000010001000000000000000000000000010000000000100
000000000000010001000000000000000000000000010000000000100
000000000000010001000000000000000000000000010000000000100
000000000000010001000000000000000000000000010001111000100
000000000000010001000000000000000000000000010001001000100
000000000000011A11000000000000000000000000011111001000100
000000000000000000000000000000000000000000000000001000100
000000000000000000000000000000000000000000000000001000100
000000000000000000000000001111111110000000000000001000100
000000000000000000000000001000000010011111100000001000100
111111111111110000000000001000000010010000100000111151111
100010001000010000000000001000000010010000100000100000001
100010z01000010000000000001000000010011110100000100000001
100010001000010000000000011000000011000010100000100000001
100011511115111111111111110000000001111110111111100000001
100000000000010000000000010000000001000000000000100000001
100000000000050000000000050000000005000000000000500000001
100000000000010000000000010000000001000000000000100000001
100011511115111111111111110000000001111111111111100000001
100010001000010000000000011000000011000000000000100000001
100010001000010000000000001000000010000000000000100000001
100010001000010000000000001000000010000000000000100000001
100010001000010000000000001000000010000000000000111151111
111111111111110000000000001000000010000000000000001000100
000000000000000000000000001110001110000000000000001000100
000000000000000000000000000011511000000000000000001111100
000000000000000000000000000010001000000000000000000000000
000000000000000000000000000110001000000000000000000000000
000000000000000000111111111100001000000000000000000000000
000000000000000000100000000000001000000000000000000000000
000000000000000000100000000000001000000000000000000000000
000000000000000000100011111100001000000000000000000000000
000000000000000000115110000110001000000000000000000000000
000000000000000001100011000010001000000000000000000000000
000000000000000001000001000010001000000000000000000000000
000000000000000001100011011111511111000000000000000000000
000000000000000001000001010000000001000000000000000000000
000000000000000001100011010000000001000000000000000000000
000000000000000001000001010000000001000000000000000000000
000000000000000001100011010000000001000000000000000000000
000000000000000001000001010000000001000000000000000000000
000000000000000001111111010000000001000000000000000000000
000000000000000000000000010000000001000000000000000000000
000000000000000000000000010000000001000000000000000000000
000000000000000000000000011111111111000000000000000000000
