1111111111111111111111
1010100000050000000021
1000000000012000000021
1111100111112000009021
1000100100012000000021
1z00500500012000009021
1000100100012000000021
11111001111123335333A1
1000100100010004040001
1000500500010400040001
1000100100010444440001
1111100111110000040001
1000000000014444040001
1000000000010000040001
1111111111115444440001
1111111111110666660001
1000000000000090909001
1000000777777000000001
1070777700007090909001
1070000000007000000001
1111111111111111111111