1111111111111111111111111111111111111111111
1000000000000000000000000000000000000000001
1020020020020020020020020020020020020020001
1000000000000000000000000000000000000000001
1000000000000000000000000000000000000000001
1020020020020020020020020020020020020020001
1000000000000000000000000000000000000000001
10z000000000000000000000000000000000000000A
1000000000000000000000000000000000000000001
1020020020020020020020020020020020020020001
1000000000000000000000000000000000000000001
1000000000000000000000000000000000000000001
1020020020020020020020020020020020020020001
1000000000000000000000000000000000000000001
1111111111111111111111111111111111111111111