22222221111111111666666666888888111111
2z000020001000005000000006000705000001
22222020001111114000000706000708000001
30002020000000004000000706000708000001
30005020000000004000000706000708000001
30002020000000005000000706000708000001
33332520000000004000000706000708000001
10000000000000004000000706000708000001
10000000000000004000000705000008000001
11111111111111111666666666888888000001
10000000000000000000000000000000000001
10000000000000000000000000000000000001
19B91111111111111111111111111111111111
C000000C00000000010000000000000000000D
C000000C00010000010000000000000000000D
CCC5CCCC00010000010000000000000000000A
C000000000010000010000000000000000000D
C000000000010000000000000000000000000D
CCCCCCCCCCCCCCCCCCCCCCCCCCCCCCCCCCCCCC