1111111111111111111117777777777777777777777711199A99111
1z00000000000000000020000000000000000000800040000000001
1000000000000000000020000000000000000000808040000000001
1000000000000000000020000000000000000000808040000000001
1000000000000000000020000000000000000000808040000000001
1000000000000000000020000000000000000000808040000000001
1000000000000000000020000000000000000000808040000000001
1000000000000000000020000000000000000000808040000000001
1333344454443333333320000000000000000000808040000000001
1000004000400000000020000000000000000000888040000000001
1000004000406060606020000000000000000000000042222B22221
1000004404400000000020000000000000000000000000000000001
1000000404006060606020000000000000000000000000000000001
1000000303000000000020000000000000000000000011111111101
1000000353000000000030000000000000000000000010000000401
1000000000000000000050000000000000000000000010004400501
1000000000000000000030000000000000000000000010044440401
1111111111111111111111111111111111111111111111111111111